11111111111111111111
1111C00000A00000C111
111A0110110110110011
11000010010010010001
1E000010110110010A01
11000010010010010001
111P0010110110010011
1111C00000000000C111
11111111111111111111