1111111111111111111111111111111111
1A0000000000000C00000C000000A00001
1010010100100000101001000000010101
1010010010101010001001000000010101
1P000E000C00C0000000000000A00000C1
1111111111111111111111111111111111